"","niv_sueldo","H","M","<NA>","total"
"1","1",64759,48743,2478,115981
"2","2",62071,39522,2709,104304
"3","3",10728,9996,647,21374
"4","4",2711,2721,188,5624
"5","5",1676,1036,89,2806
"6","6",994,583,52,1635
"7","7",60,45,5,117
"8","8",84,40,7,139
"9","9",103,39,11,162
"10","10",161,77,10,258
"11","11",43,20,6,80
